S......._.
........|.
__|__|_.|.
..|..|..|.
..|..|..|.
..|_.|._|.
..|.....|.
_.|___._|.
........|.
..|......F
