....S.....
..XX......
.XXX..XXXX
...XX.....
XX.......O